.s........................
..........................
..##..##..##..##..##..##..
..##..##..##..##..##..##..
..##..##..##..##..##..##..
..######..##..##..######..
..######..##@@##..######..
..######..##@@##..######..
..##..##..##..##..##..##..
..##..##..........##..##..
..##..##..........##..##..
..........##..##........s.
..........##..##..........
##..####..........####..##
@@..####..........####..@@
........s.##..##..........
..........######..........
..##..##..######..##..##..
..##..##..##..##..##..##..
..##..##..##..##..##..##..
..##..##..##..##..##..##..
..##..##..........##..##..
..##..##..........##..##..
..##..##..........##..##..
.s..........!.............
.......................... 
