 s...........s..........s.
..........................
..##..##..##..##..##..##..
..##..##..##..##..##..##..
..##..##..##..##..##..##..
..######..##..##..######..
..######..##@@##..######..
..######..##@@##..######..
..##..##..##..##..##..##..
..##..##..........##..##..
..##..##..........##..##..
..........##..##..........
..........##..##..........
##..####..........####..##
@@..####..........####..@@
..........##..##..........
..........######..........
..##..##..######..##..##..
..##..##..##..##..##..##..
..##..##..##..##..##..##..
..##..##..##..##..##..##..
..##..##..........##..##..
..##..##..........##..##..
..##..##...####...##..##..
...........#!.#...........
...........#..#........... 
