........@@................
........@@..............s.
@@@@....@@....@@@@........
@@@@....@@....@@@@........
..@@....@@......@@..@@@@..
..@@....@@......@@..@@@@..
..@@....@@@@@@......@@....
..@@....@@@@@@..##..@@....
..##........@@..@@@@@@....
..##........@@..@@@@@@....
##@@@@..@@##@@####........
##@@@@..@@##@@####........
....@@##@@##....##....@@@@
....@@..@@......##....@@@@
....@@..........@@....@@..
....@@..........@@....@@..
....##....@@....@@@@##@@..
....##....@@....@@@@##@@..
..@@@@@@....##@@@@..##@@..
..@@@@@@....##@@@@..##@@..
......##..............##..
......##...........s..##..
......@@..............##..
......@@..............##..
.s....@@....!.....@@..##..
......@@..........@@..##.. 
