........@@................
........@@..............s.
@@@@....@@....@@@@........
@@@@....@@....@@@@........
..@@....@@......@@..@@@@..
..@@....@@......@@..@@@@..
..@@....@@@@........@@....
..@@....@@@@@...##..@@....
..##................@@....
..##........@@......@@....
##@@@@....................
##@@@@....................
....@@##@@##....##....@@..
....@@..@@......##....@@..
....@@..........@@....@@..
....@@..........@@....@@..
....##....@@..........@@..
....##....@@..............
..@@@@@@....##@@..........
..@@@@@@....##@@....##@@..
......##..............##..
......##...........s......
........................##
...........####...........
.s.........#!.#.........##
...........#..#........... 
