.s............@@@@........
..........................
....@@@@@@@@........@@....
....@@..............@@....
....@@......##..@@@@@@....
....@@......##....@@@@....
..@@......##@@......@@....
..@@......##@@......@@....
........##@@@@......@@@@..
........####@@........@@..
..@@..########..@@........
..@@..####.@@@..@@........
...@..@@@@......@@@@....s.
...@..@@@@......@@@@......
@.......@@..######.....@..
@.......@@..######.....@..
...@@@......@@@@##....@@..
...@@@......@@@@##....@@..
..@@........####....@@@@..
..@@........####....@@@@..
..@@@@@@....####..@@......
......@@....####..@@......
..................@@....@@
.s....................@@@@
............!.............
@@@@.................s....
