..........................
..s........s.......s......
..........................
..........................
#####...##################
..........................
~~~~~~~~~~~~~~~~~~~~...~~~
..........................
..........................
..........................
..........................
..........................
..........................
..........................
..........................
..........................
..........................
..........................
..........................
..........................
..........................
..........................
..........................
..........................
..........................
..........................
