..........................
.####....~~~~....@@@@.....
.####....~~~~....@@@@.....
.####....~~~~....@@@@.....
.####....~~~~....@@@@.....
..........................
..........................
..s........s.......s......
..........................
..........................
..........................
..........................
..........................
..........................
..........................
..........................
..........................
..........................
..........................
..........................
..........................
..........................
..........................
..........................
..........................
..........................
